111111
100001
1NCPE1
100001
111111