1111111111111111111111111111111111111111111111111111111111111111111111111111111111111111111111111111111111111111111111111111111111
1010001011101110100000000000000000000000000000000000000000000000000000000000000000000000000000000000000000000000000000000000001111
1010101111111111111000000000000000000000000000000000000000000000000000000000000000000000000000000000000000000000000000000000000011
1000000P00000000000000000000000000000000000000000000000000000000000000000000000000000000000000000000000000000000000000000000001111
1011101011111010111000000000000000000000000000000000000000000000000000000000000000000000000000000000000000000000000000000000000011
1111111011101010001000000000000000000000000000000000000000000000000000000000000000000000000000000000000000000000000000000000000011
1000111011111010111000000000000000000000000000000000000000000000000000000000000000000000000000000000000000000000000000000000000011
1010101011111110100000000000000000000000000000000000000000000000000000000000000000000000000000000000000000000000000000000000001011
1110111010001010111000000000000000000000000000000000000000000000000000000000000000000000000000000000000000000000000000000000000011
1000C00C10101000000000000000N000000000000000000000000000000000000000000000000000000000000000000000000000000000000000000000000000E1
1111111111111111111111111111111111111111111111111111111111111111111111111111111111111111111111111111111111111111111111111111111111